.WW----WWWWWWWWWWWWWWWWWWWWWWWWWWWWWWW.
.W###################################W.
.W##P######################S#########W.
.W###################################W.
.W###################################W.
.W##############################S####W.
.W###################################W.
.WWWWWWWWWWWWWWWWWWWWWWWWWWWWWWWWWWWWW.