.WW----WWWWWWWWWWWWWWWWWWWWWWWWWWWWWWW.
.W###################################W.
.W##P################################W.
.W###################################W.
.W###################################W.
.W###################################W.
.W###################################W.
.WWWWWWWWWWWWWWWWWWWWWWWWWWWWWWWWWWWWW.