.....................................
.WWWWW-----WWWWWWWWWWWWWWWWWWWWWWWWW.
.W#####P###########################W.
.W#################################W.
.W#################################W.
.W#################################W.
.W#################################W.
.W#################################W.
.W#################################W.
.WWWWWWWWWWWWWWWWWWWWWWWWWWWWWWWWWWW.
.....................................